박팽년 4 3 4
성삼문 2 1 3
유성원 5 1 1
유응부 3 5 2
이개 1 7 1
하위지 4 2 4